[],[],[],[],[],[],[],[],[],[],[],[],[],[],[],[],[],[],[],[],[],[],[],[],[],[],[],[],[],SP,[],[],[],[],[]
[],[],[],[],[],[],[],[],[],[],[],[],[],[],[],[],EB,EB,[],[],[],[],[],[],[],[],[],[],[],  ,[],[],[],[],[]
[],ES,  ,  ,  ,  ,  ,  ,  ,ES,  ,  ,  ,  ,  ,  ,  ,  ,  ,  ,  ,  ,  ,  ,  ,  ,  ,  ,  ,  ,  ,  ,EG,  ,[]
[],[],[],[],  ,[],  ,[],[],[],[],[],[],[],[],[],  ,  ,[],[],[],[],  ,[],[],[],[],[],{},[],[],[],[],  ,[]
[],  ,  ,  ,  ,[],ES,[],[],[],[],[],[],[],[],[],  ,  ,  ,  ,  ,  ,  ,[],[],KY,  ,  ,  ,[],[],[],[],  ,[]
[],EB,[],[],[],[],  ,[],[],[],[],[],[],[],[],[],  ,[],[],[],[],  ,  ,[],[],  ,[],[],<3,[],[],  ,[],  ,[]
[],  ,  ,  ,ES,  ,  ,  ,ES,  ,  ,  ,ES,  ,  ,  ,  ,[],[],[],[],  ,[],[],[],  ,[],[],SY02U05D03U,[],[],  ,[],  ,[]
[],  ,[],  ,[],[],[],[],[],  ,[],[],[],[],[],[],  ,[],[],  ,  ,  ,[],SY05R05L,  ,  ,  ,  ,  ,[],[],  ,[],  ,[]
[],  ,[],SG,  ,  ,  ,[],[],  ,[],[],[],[],[],[],  ,[],[],EB,[],[],[],[],[],  ,[],[],  ,[],[],  ,[],  ,[]
[],  ,[],[],  ,[],  ,  ,  ,  ,  ,  ,  ,ES,  ,  ,  ,  ,  ,  ,[],[],  ,[],[],KY,[],[],  ,[],[],EG,[],  ,[]
[],  ,  ,  ,  ,[],[],[],[],  ,[],[],[],  ,[],[],  ,[],[],  ,[],[],  ,  ,[],[],[],[],[],[],  ,  ,[],  ,[]
[],KY,[],[],[],[],[],EB,  ,  ,[],[],[],  ,[],[],  ,[],[],[],[],[],EB,  ,[],[],[],[],  ,[],[],  ,[],  ,[]
[],[],[],[],[],[],[],[],[],  ,[],  ,[],  ,[],[],  ,  ,  ,  ,  ,  ,  ,  ,  ,EG,  ,  ,  ,[],[],  ,[],  ,[]
[],[],[],[],[],[],[],[],[],  ,[],  ,  ,  ,  ,  ,  ,[],[],  ,[],  ,[],[],[],  ,[],[],[],[],[],EG,[],  ,[]
[],  ,[],[],[],[],[],[],[],  ,[],  ,[],[],[],[],  ,EB,[],ES,[],ES,[],[],[],  ,[],[],[],[],[],  ,[],  ,[]
[],ES,[],[],  ,  ,EB,  ,  ,  ,[],  ,[],[],[],[],  ,[],[],  ,[],  ,[],[],[],  ,  ,  ,  ,  ,  ,  ,[],  ,[]
[],  ,{},{},EB,[],[],[],[],  ,  ,SG,[],[],  ,  ,EB,  ,[],ES,[],ES,[],[],[],  ,[],[],[],[],[],  ,  ,  ,[]
[],  ,[],[],[],[],[],[],[],[],[],  ,[],[],  ,[],[],[],[],  ,ES,  ,  ,  ,  ,  ,[],[],[],[],[],[],  ,[],[]
[],  ,  ,  ,  ,  ,  ,  ,  ,EG,[],  ,  ,  ,  ,EG,[],[],[],[],[],[],[],[],[],  ,  ,  ,  ,ES,  ,  ,  ,  ,[]
[],[],[],[],[],[],  ,  ,[],[],[],[],[],[],[],[],[],[],[],[],[],[],[],[],[],[],[],[],[],[],[],[],[],[],[]
