#,#,#,#,#,#,#,#,#,#,#,#,#,#,#,#,#,#,#,entry, ,#,#,#,#,#,#,#,#,#,#,#,#,#,#,#,#,#,#,#
#,#,#,#,#,#,#,#,#,#,#,#,#,#,#,#,#,#,#, , ,#,#,#,#,#,#,#,#,#,#,#,#,#,#,#,#,#,#,#
#, , , , , , , , , , , , , , , , , , , , ,#,#, , , , , , , , , ,#,#,#,#,#,#,#,#
#, , , , , , , , , , , , , , , , , , , , ,#,#, , , , , , , , , ,#,#,#,#,#,#,#,#
#, , , ,#,#,#,#,#,#,#,#,#,#,#,#,#,#,#, , , , , , ,#,#,#,#,#, , , , , , , , ,#,#
#, , , , , , , , ,#,#,#,#,#,#,#,#,#,#, , , , , , ,#,#,#,#,#, , , , , , , , ,#,#
#, , , , , , , , ,#,#,#,#,#,#,#,#,#,#, , , , , , , , ,#,#,#, , ,#,#, , , , ,#,#
#, , , , , , , , ,#, , , , , , , ,#,#, , , , , , , , ,#,#,#, , ,#,#, , , , ,#,#
#, , , , , , , , ,#, , , , , , , ,#,#, , ,#,#,#, , , ,#,#,#, , ,#,#, , , , ,#,#
#, , , , , , , , ,#, , , , , , , , , , , ,#,#,#, , , ,#,#,#, , ,#,#, , , , ,#,#
#, , , , , , , , ,#, , , , , , , , , , , ,#,#,#,#, , , , , , , , , , , , , ,#,#
#, , , , , , , , ,#, , , ,#,#,#,#,#,#,#,#,#,#,#,#, , , , , , , , , , , , , ,#,#
#, , , , , , , , ,#, , , ,#,#,#,#,#,#,#,#,#,#,#,#,#,#,#,#,#,#,#,#,#,#,#,#,#,#,#
#,#,#,#,#,#,#,#,#,#, , , ,#,#,#,#,#,#,#,#,#,#,#,#,#,#,#,#,#,#,#,#,#,#,#,#,#,#,#
#,#,#,#,#,#,#,#,#,#, , , ,#,#,#,#,#,#,#,#,#,#,#,#,#,#,#,#,#,#,#,#,#,#,#,#,#,#,#
#,#,#,#,#,#,#,#,#,#, , , ,#,#,#,#,#,#,#,#,#,#,#,#,#,#,#,#,#,#,#,#,#,#,#,#,#,#,#
#,#,#,#,#,#,#,#,#,#, , , ,#, , , , , , , , , , ,#,#,#,#,#,#,#,#,#,#,#, , , ,#,#
#,#,#,#,#,#,#,#,#,#, , , ,#, , , , , , , , , , ,#,#,#,#,#,#,#,#,#,#,#, , , ,#,#
#,#,#,#,#,#,#,#,#,#, , , ,#, , , , , , , , , , ,#,#,#,#,#,#,#,#,#,#,#, , , ,#,#
#,#,#,#,#,#,#,#,#,#, , , ,#, , , , , , , , , , ,#,#,#,#,#,#,#,#,#,#,#, , , ,#,#
#, , , , , , , , , , , , , , , , , , , , , , , , , , , , , , ,#,#,#,#, , , ,#,#
#, , , , , , , , , , , , , , , , , , , , , , , , , , , , , , ,#,#,#,#, , , ,#,#
#, , , ,#,#,#,#,#,#,#,#,#,#, , , , , , , , , , ,#,#,#, , , , , , , , , , , ,#,#
#, , , ,#,#,#,#,#,#,#,#,#,#, , , , , , , , , , ,#,#,#, , , , , , , , , , , ,#,#
#, , , ,#,#,#,#,#,#,#,#,#,#,#,#,#,#,#,#,#,#,#,#,#,#,#,#,#,#,#,#,#,#,#,#,#,#,#,#
