[],[],[],[],[],[],[],[],[],[],[],[],[],[],[],[],[],[],[],[],[],[],[],[],[],[],[],[],[],SP,[],[],[],[],[]
[],[],[],[],[],[],[],[],[],[],[],[],[],[],[],[],EG,EG,[],[],[],[],[],[],[],[],[],[],[],AM,[],[],[],[],[]
[],ES,  ,  ,  ,  ,  ,  ,  ,SY07L07R,  ,  ,  ,  ,  ,  ,  ,  ,  ,  ,  ,  ,  ,  ,  ,  ,  ,  ,  ,  ,  ,  ,BD,  ,[]
[],[],[],[],  ,[],  ,[],[],[],[],[],[],[],[],[],  ,  ,[],[],[],[],##,[],[],[],[],[],{},[],[],[],[],  ,[]
[],  ,  ,  ,  ,[],ES,[],[],[],[],[],[],[],[],[],  ,  ,  ,  ,  ,  ,##,[],[],KY,  ,  ,  ,[],[],[],[],  ,[]
[],EB,[],[],[],[],  ,[],[],[],[],[],[],[],[],[],  ,[],[],[],[],  ,##,[],[],  ,[],[],<3,[],[],  ,[],  ,[]
[],  ,  ,  ,ES,  ,  ,  ,ES,  ,  ,  ,ES,  ,  ,  ,  ,[],[],[],[],  ,[],[],[],  ,[],[],SY02U05D03U,[],[],  ,[],  ,[]
[],  ,[],  ,[],[],[],[],[],  ,[],[],[],[],[],[],  ,[],[],  ,  ,  ,[],SY05R05L,  ,  ,  ,  ,  ,[],[],  ,[],  ,[]
[],  ,[],  ,  ,  ,  ,[],[],  ,[],[],[],[],[],[],  ,[],[],EB,[],[],[],[],[],  ,[],[],  ,[],[],  ,[],  ,[]
[],  ,[],[],  ,[],  ,  ,  ,  ,  ,  ,  ,ES,  ,  ,  ,  ,  ,  ,[],[],  ,[],[],KY,[],[],  ,[],[],EG,[],  ,[]
[],  ,  ,  ,  ,[],[],[],[],  ,[],[],[],  ,[],[],  ,[],[],  ,[],[],  ,  ,[],[],[],[],[],[],  ,  ,[],  ,[]
[],KY,[],[],[],[],[],EB,  ,  ,[],[],[],  ,[],[],  ,[],[],[],[],[],EB,  ,[],[],[],[],  ,[],[],  ,[],  ,[]
[],[],[],[],[],[],[],[],[],  ,[],  ,[],  ,[],[],  ,  ,  ,  ,ES,  ,  ,  ,  ,EG,  ,  ,  ,[],[],  ,[],  ,[]
[],[],[],[],[],[],[],[],[],  ,[],  ,  ,  ,  ,  ,  ,[],[],  ,[],  ,[],[],[],  ,[],[],[],[],[],EG,[],  ,[]
[],  ,[],[],[],[],[],[],[],  ,[],  ,[],[],[],[],  ,EB,[],ES,[],ES,[],[],[],  ,[],[],[],[],[],  ,[],  ,[]
[],ES,[],[],  ,  ,EB,  ,  ,  ,[],  ,[],[],[],[],  ,[],[],  ,[],  ,[],[],[],  ,  ,  ,  ,  ,  ,  ,[],  ,[]
[],  ,{},{},EB,[],[],[],[],  ,  ,SG,[],[],  ,  ,EB,  ,[],ES,[],ES,[],[],[],  ,[],[],[],[],[],  ,  ,  ,[]
[],  ,[],[],[],[],[],[],[],[],[],  ,[],[],  ,[],[],[],[],  ,ES,  ,  ,  ,  ,  ,[],[],[],[],[],[],  ,[],[]
[],  ,  ,  ,  ,  ,  ,  ,  ,EG,[],  ,  ,  ,  ,EG,[],[],[],[],[],[],[],[],[],  ,  ,  ,  ,ES,  ,  ,  ,  ,[]
[],[],[],[],[],[],  ,  ,[],[],[],[],[],[],[],[],[],[],[],[],[],[],[],[],[],[],[],[],[],[],[],[],[],[],[]
